"filename", "language", "Java", "comment", "blank", "total"
"c:\Users\lukas\Desktop\Game\src\DungeonMaster.java", "Java", 260, 5, 54, 319
"c:\Users\lukas\Desktop\Game\src\TileEditor.java", "Java", 2, 0, 0, 2
"c:\Users\lukas\Desktop\Game\src\characters\BigZombie.java", "Java", 59, 0, 8, 67
"c:\Users\lukas\Desktop\Game\src\characters\Character.java", "Java", 11, 0, 5, 16
"c:\Users\lukas\Desktop\Game\src\characters\CharacterFactory.java", "Java", 1, 0, 0, 1
"c:\Users\lukas\Desktop\Game\src\characters\Knight.java", "Java", 4, 0, 1, 5
"c:\Users\lukas\Desktop\Game\src\characters\Skelet.java", "Java", 80, 0, 17, 97
"c:\Users\lukas\Desktop\Game\src\characters\TinyZombie.java", "Java", 52, 0, 5, 57
"c:\Users\lukas\Desktop\Game\src\characters\Wizard.java", "Java", 4, 0, 1, 5
"c:\Users\lukas\Desktop\Game\src\gui\game\HealthIndicator.java", "Java", 60, 0, 15, 75
"c:\Users\lukas\Desktop\Game\src\gui\widgets\Label.java", "Java", 21, 18, 5, 44
"c:\Users\lukas\Desktop\Game\src\sound\SoundsManager.java", "Java", 31, 0, 12, 43
"Total", "-", 585, 23, 123, 731